6, 5,
X, 0, 1, 0, X, X,
X, 0, X, 0, 0, 0,
0, 0, X, X, X, 2,
0, X, 0, X, 0, 0,
3, 0, 0, 0, 0, X,