11, 11,
1, 0, 0, 0, 0, X, 5, 0, X, 0, 3,
0, 0, 0, 0, 0, X, 0, 0, X, 0, 0,
0, 0, 0, 0, 0, X, 0, 0, X, 0, 0,
0, 0, X, 0, 0, X, 0, 0, 0, 0, 0,
0, 0, X, 0, 0, X, 0, 0, 0, 0, 0,
0, 0, X, 0, 0, 0, 0, 0, 0, 0, 0,
0, 0, X, 0, 0, X, 0, 0, 0, 0, 0,
0, 0, X, 0, 0, X, 0, 0, 0, 0, 0,
0, 0, 0, 0, 0, X, 0, 0, X, 0, 0,
0, 0, 0, 0, 0, X, 0, 0, X, 0, 0,
7, 4, 0, 0, 0, X, 2, 0, X, 0, 6,
